00000000000000000000000000000000
01111111111111111111111111111110
01111100000111111111100001111110
01111100000111111111100001111110
01111100000111111111100001111110
01111111111111111111111111111110
01111111111111111111111111111110
01111100000111111111100001111110
01111100000111111111100001111110
01111100000000000000000001111110
01111100000000000000000001111110
01111100000111111111100001111110
01111100000111111111100001111110
01111100000111111111100001111110
01111111111111111111111111111110
01111111111111111111111111111110
01111100000111111111100001111110
01111100000111111111100001111110
01111111111111111111111111111110
00000000000000000000000000000000