000000000000000
011111111111110
012111111111210
011111111111110
011111111111110
011111111111110
011111111111110
011111111111110
011111111111110
011111111111110
011111111111110
011111111111110
012111111111210
011111111111110
000000000000000