000000000000000000000000000000000
011111111111111101111111111111110
011111111111111101111111111111110
011111111111111101111111111111110
011111112111111101111111211111110
011111111111111101111111111111110
011111111111111101111111111111110
011111111111111101111111111111110
000000000000000000000000000000000
011111111111111101111111111111110
011111111111111101111111111111110
011111111111111101111111111111110
011111112111111101111111211111110
011111111111111101111111111111110
011111111111111101111111111111110
011111111111111101111111111111110
000000000000000000000000000000000