0000000000000000000000000000000000000000000000000000000000000000000
0000000000000000000000000000011111111100000000000000000000000000000
0000000000000001111001111000010000000100001111001111000000000000000
0000000000000011111111111111110000000111111111111111100000000000000
0000000000111111001111001111010000000101111001111001111110000000000
0011110001110000000000000011011100011101100000000000000111000111100
0012111001000000000000000011000111110001100000000000000001001112100
0011111111110000000000000011000000000001100000000000000111111111100
0011111111310001111111111111110000000111111111111111000131111111100
0011111111110011111111111111111000001111111111111111100111111111100
0011111110000111111111111111111100011111111111111111110000111111100
0011111100001111111111111111111111111111111111111111111000011111100
0011111000001111111111111111111111111111111111111111111000001111100
0011111000001111111121111111111111111111111111211111111000001111100
0011111000001111111111111111111111111111111111111111111000001111100
0011111000001111111111111111111111111111111111111111111000001111100
0011111000000011111111111111111111111111111111111111100000001111100
0011111001100011111111111111111111111111111111111111100011001111100
0001310001100000000000000000000011100000000000000000000011000131000
0001110001100011111111111111111111111111111111111111100011000111000
0000000011111111111111111111111111111111111111111111111111100000000
0000000013111111111111111111111112111111111111111111111113100000000
0000000011111111111111111111111111111111111111111111111111100000000
0001110001100011111111111111111111111111111111111111100011000111000
0001310001100000000000000000000011100000000000000000000011000131000
0011111001100011111111111111111111111111111111111111100011001111100
0011111000000011111111111111111111111111111111111111100000001111100
0011111000001111111111111111111111111111111111111111111000001111100
0011111000001111111111111111111111111111111111111111111000001111100
0011111000001111111121111111111111111111111111211111111000001111100
0011111000001111111111111111111111111111111111111111111000001111100
0011111100001111111111111111111100011111111111111111111000011111100
0011111110000111111111111111111100011111111111111111110000111111100
0011111111110011111111111111111000001111111111111111100111111111100
0011111111310001111111111111110000000111111111111111000131111111100
0011111111110001000000000000000000000000000000000001000111111111100
0012111000000001000000000000000111110000000000000001000000001112100
0111110000000111000111100111100100010011110011110001110000000111110
0100000000111101111111111111111100011111111111111111011110000000010
0111100011100111011100111100110100010110011110000001110011100011110
0000111110000000000000000000000111110000000000000000000000111110000
0000000000000000000000000000000000000000000000000000000000000000000
