0000000000000000000000000000000000000000000000000000000000000000000
0000000000000000000000000000011111111100000000000000000000000000000
0000000000000001111001111000011111111100001111001111000000000000000
0000000000000011111111111111111000001111111111111111100000000000000
0000000001111111001111001111011000001101111001111001111111000000000
0011110011110000000000000011011111111101100000000000011111100111100
0012111011000000000000000011001111111001100000000000000001101112100
0011111111110000000000000011000000000001100000000000000111111111100
0011111111310001111111111111110000000111111111111111000131111111100
0011111111110011111111111111111000001111111111111111100111111111100
0011111110000111111111111111111100011111111111111111110000111111100
0011111100001111111111111111111111111111111111111111111000011111100
0011111000001111111111111111111111111111111111111111111000001111100
0011111000001111111121111111111111111111111111211111111000001111100
0011111000001111111111111111111111111111111111111111111000001111100
0011111000001111111111111111111111111111111111111111111000001111100
0011111000000011111111111111111111111111111111111111100000001111100
0011111001100011111111111111111111111111111111111111100011001111100
0001310001100000000000000000000011100000000000000000000011000131000
0001110001100011111111111111111111111111111111111111100011000111000
0000000011111111111111111111111111111111111111111111111111100000000
0000000013111111111111111111111112111111111111111111111113100000000
0000000011111111111111111111111111111111111111111111111111100000000
0001110001100011111111111111111111111111111111111111100011000111000
0001310001100000000000000000000011100000000000000000000011000131000
0011111001100011111111111111111111111111111111111111100011001111100
0011111000000011111111111111111111111111111111111111100000001111100
0011111000001111111111111111111111111111111111111111111000001111100
0011111000001111111111111111111111111111111111111111111000001111100
0011111000001111111121111111111111111111111111211111111000001111100
0011111000001111111111111111111111111111111111111111111000001111100
0011111100001111111111111111111100011111111111111111111000011111100
0011111110000111111111111111111100011111111111111111110000111111100
0011111111110011111111111111111000001111111111111111100111111111100
0011111111310001111111111111110000000111111111111111000131111111100
0011111111110001100000000000000000000000000000000011000111111111100
0012111000000001100000000000000111110000000000000011000000001112100
0011110000000111100111100111100111110011110011110011110000000111100
0011000000111101111111111111111110111111111111111111011110000001100
0011100011111111011100111100110111110110011110000001111111100011100
0000111110000000000000000000000111110000000000000000000000111110000
0000000000000000000000000000000000000000000000000000000000000000000